R.......
..#......
.R....#..
.........
.........
.....##..
.........
.........
.....#.B.
..#......
