.....Y.....
...........
..##...##..
..#.....#..
...........
B....#....B
...........
..#.....#..
..##...##..
...........
.....Y.....